1111111111111
1C110000C0001
1000011111001
1000111E00P01
1111111111111